11111111111111
1000C1110000E1
10100000011C11
1P0010C0111111
11111111111111
