11111111111111
1000C1110000E1
1010000N011C11
1P0010C0000N11
11111111111111
