1111111111111111
100C0011110000E1
1P10100000001111
1000001C100000C1
1111111111111111
