1111111111111111
100C0N11110000E1
1P101000000N1111
1000001C1N0000C1
1111111111111111
