11111
1P1E1
10001
10CN1
11111
